*******************************************************
*  *  ***********                **                 ***
*  *  *  ******   ******  *****  ** *****    *****   **
*  *  *  ******   **       ****     ******   ******  **
*       **      **  ***********      **     *******  **
****   *   **  **  ********        ****************  **
*****  * *******  *********   ***  *******    **     **
*        ***                  ***  ********  ****  ****
*  ***   ***  **************  ****                   **
*   **        ****     *****  *******************  ****
**  *************  *  ******  ***     ***            **
**  **   *******  **                 ******  ******  **
**  **           ******************          **      **
**       ********************        ******************
*******************************   *****             ***
*******************                     ***************
*******************************************************
