********************************
* *                 *          *
*    *    *     * *            *
**  ***** * ** ** * ********** *
*    *    * *   * *     *      *
*    ****** ***** **************
*    *          *              *
******** ************ **********
* *       *         *          *
*    *    *     * *            *
**  ***** * ** ** * ********** *
*    *    * *   * *     *      *
*    ****** ***** **************
*    *          *              *
********************************
