***************************
*      *                  *
*             *****  ***  *
*      *      *        *  *
************************  *
*      *                  *
*  *          *****  ***  *
*  *   *      *        *  *
*  ************        *  *
*      *               *  *
*             **********  *
*      *               *  *
*  *******  ************  *
*      *      *           *
*  *          **********  *
*  *   *      *           *
***************************
