******************************************************************************
***  **** **** ****      ****   ******   ****  ***   **     *   *****      ***
**    *       *         *   *  *** ***     *             **  * ****    **    *
****     ****    *               ****  **     ***         *       ***       **
****  **** ** *  * **  **   ****   *****  **   **     **       *** **     ** *
**    **              ** **** *     * *              **    ***       *    * **
**        * ***  **     ***   **  *   *    ****  ***   *    ****  **      ****
***    **        ***    ***      **   **   ***    **   ***      * ****      **
****  **  **   *   *          ***   **        ****  **  ***    **** ****     *
*****     **     **      *    **          **      ***     **  * ** **   **  **
**    ***     **  *    *    *   ***    **      **       ** *****   ****     **
**             ***   **** *    ***  ***  *    *   **     ***      *    ***  **
***     **  *  **    *   ***  **        *   *****    ***   ***   ****        *
***      ****   ***      ***       **    ***   **     ****                ****
*****     *    ****     ***    ***     ***  **                 **    **     **
*     *        **   *  **    ***  *  **       ***  **   *           **      **
*****      *    **    *         *    ***    ****           **       *   ** ***
**     ***  **   *        *   *    *    ****    ****   ***    **       ***  **
** ***   *** ***  *                    ****          **  **   ***   *   *   **
***    **    * *      **     *       ** ***    **** ***    ***     *******  **
****   ****         *     ** * *  *    ***    **     ***  *    ***   ** *    *
******* ** **      ****  ****       **  **  **** ** **    *** ****   **** * **
****   **  ***  **   *         ***         ** **** *  * **** **** ** ***    **
***** *   **       ** **  ** **   ** ****     **  *** ** ***   ***         ***
***  *        *** *              **** **  *   ****   *             ***     ***
**   *   *   *         **     **   ***               *        ** **    ** ****
***         ****    **    **      **  ***    ****  *****  *  *  ******  ******
******************************************************************************
